##########################
#                       S#
# #### ################# #
# ####      ############ #
# ######### ############ #
# ######### ############ #
# #########  #######   # #
# ########## ##   ## # # #
# ##########E## # ## # # #
# ########## ## # ## # # #
#         ##    # ## # # #
# ####### #######    #   #
# ####### ############ # #
# #######              # #
# ###################### #
#                        #
##########################



